1111111111111111111111111111111111
100000000000000C00000C000000000001
1010010100100000101001000000010101
1010010001101010001001000000010101
100001001C00C0000000000000000000C1
1000010100000000000000000000000001
1000011000100000E00000000000010001
10000100000100C0000000000010000001
100001C000101000000000000100000001
1000010000000000000000000100000001
1000010000010000000000C00000000001
1P00000000000000000010000100000001
1111111111111111111111111111111111
