11111111111111111111111111111111111111
10000000000000000000000000000000000C01
10E00000000001111110011111111111111101
100000000011111111C0011111001111111101
100000001111111PC00001110C001111111101
1000011111111C000000010000001111111C01
1001111111C000000000000001111111100001
10111111C00000000000000111111100000001
101111CCCCCCC0CCCCCC011111110000000101
10111111111111111110011111110000011101
10111111111111111110011111110011111101
10111111111111111110011111111111111101
100C0000000001111110000000000000000001
10000000000C011111100000000C0000000001
10000000000C00000000000000000000000001
10000000000C000000000000000C0000000001
11111111111111111111111111111111111111
